
;545465464
;546546453
;465465456
;555656566
;579595262
;565656232